word	hint	Scrambelled
emotional	having feelings that are easily excited	word
Christmas	Santa comes at	htimcssar
recommend	push for something	rmemoencd
champagne	bubbles in a glass	npgmcaeah
subtitles	On foreign movies	istltsebu
happiness	What we aim for	nphsaspei
president	Biden, Trump, Bush	teenpisrd
surrender	General Custer	neurdrres
relatives	family	eviertsla
whistling	7 dwarfs did this	nsghltiwi
represent	take the place	terpernse
precisely	exactness	sliprecey
assistant	PA	isatnstsa
knowledge	information can be	lodwekegn
childhood	being a kid	cddohliho
interfere	come between 	enfrreeit
otherwise	other than as supposed or expected	eosrietwh
prisoners	in jail	resnprsoi
situation	the general state of things	stoaintiu
executive	business position	euevxetci
existence	the state or fact of existing	itexsecne
recording	copying, documenting	diocrgren
employees	colleagues	elpmseyoe
buildings	a structure	usdlnigbi
daughters	female children	sargdehut
telephone	make a call	leentehpo
attention	the process whereby a person concentrates	tneatotin
thousands	a number	uhsosandt
screaming	sharp piercing cry	simgrnaec
Hollywood	place in Wicklow and USA	ylolohodw
listening	hearing	iltenigsn
basically	in essence	ialyacsbl
apartment	a small home	mtetranpa
organised	prepared	ieoagnrds
mountains	large hills	niaosmtun
depressed	downhearted	sesderdpe
kidnapped	happened to Shergar	dppikaden
underwear	boxers	eenrwdaru
nightmare	disaster	inmetgrha
dismissed	loose your job	dissmsedi
invisible	cannot see	lsbineiiv
answering	react verbally	rewniangs
guarantee	quality assurance	egtureana
extremely	to a high degree	emleexytr
inspector	Job with PSNI or Gardai	tcrsnpieo
potential	Young players have this	tlietpaon
beautiful	lovely	lueubtafi
greetings	hello	tngsrieeg
paperwork	forms, documents etc.	rerakwpop
backwards	toward the back 	kcbadawsr
protected	shield 	dtcertope
Christian	a religious person 	siirhacnt
treatment	care provided	rmneattet
destroyed	broken	edtrysdeo
adventure	exciting undertaking	uvreanedt
insurance	expensive but required	raunncsei
favourite	a competitor thought likely to win	oraiuevtf
brilliant	of surpassing excellence	rnitblail
afternoon	part of the day	taonrnfoe
regarding	deem to be	iadgnergr
reception	the manner in which something is greeted	neceporit
suspected	imagine to be the case or true	detesucps
abandoned	forsake, leave behind	bananedod
direction	a line leading to a place or point	trinicode
valentine	a sweetheart 	nvilnatee
signature	use on official documents	gueriants
necessary	anything indispensable	nrecseays
expensive	dear	pxseiveen
miserable	very unhappy	raiseblme
decisions	making up your mind	eiincsosd
policeman	a member of a police force	aecmolinp
chuckling	laugh quietly or with restraint	lkiugchnc
authority	make decisions	yoarittuh
suffering	a state of acute pain	grsnfuife
committed	perform an act	dteicmmot
mentioned	make reference to	imnteeond
recovered	gotten better	rveecdreo
following	coming after	lliwonogf
basically	simply	lbaycisal
secretary	PA  	stcyeearr
breakfast	meal in the morning	rtakseabf
searching	looking	cegiarshn
education	Important for us all	udoanceit
transport	a train is a type of	rsprnttao
community	important to be part of this 	itmcmoyun
operation	happens in hospital	oenitpoar
candidate	a politician is one	iadctadne
strangers	does not belong	agsnrrtse
exhausted	tired	dhastxeue
seriously	Really?	yislsreou
including	have as a part	dunlcigni
explained	make plain 	npldixeea
defendant	a person in court	efdndnate
perfectly	bang on	rpytceefl
effective	having a striking effect	tvffeeeic
testimony	a solemn statement	iostytmne
currently	now	yurcnlrte
excellent	very good;	lxetnecle
different	not the same	defrtfnie
concerned	be relevant to	cnrdnceeo
sacrifice	the act of losing	fecarisci
Americans	live in USA	nsamaierc
forbidden	command against	fdrnboide
challenge	hard	helnaeclg
obviously	unmistakably	vibluyoso
traveling	moving	iarnlvgte
continues	ongoing	eunicstno
delicious	lovely	liduieosc
carefully	paying attention	relflcyau
technique	a practical method 	niehqeutc
principal	 on which interest is calculated	plicpainr
newspaper	you need these!	nrpwsepae
continued	to be …	inetcndou
honeymoon	after marriage	nhoeyonmo
recognise	Know	ecoigsner
surprised	shock	rsspiduer
condition	a state at a particular time	onnoictdi
sometimes	on certain occasions	messotemi
convinced	validity of something	ndionccve
terrified	frighten greatly	tirfridee
bothering	take the trouble	igbnretoh
structure	building	rursttuec
commander	an officer	cedrmanmo
terrorist	a radical 	retirotrs
discovery	the act of discovering something	edsivryco
cigarette	smokes	eeaitgcrt
returning	go or come back to place,	gritrnnue
computers	a machine 	moptusrce
sensitive	some people are	eneiitvss
Australia	Aboriginal tribes live here	atiarslau
witnesses	seeing something	seenwsist
questions	?'s	snoiteuqs
ambulance	hospital	uaaenbclm
ourselves	us	sersluoev
impressed	good impression	mpdseiers
companies	conduct business	apmnseioc
everybody	all of us	beyvordey
somewhere	an unknown location	reheosemw
interview	new job 	itrneewvi
wonderful	good or great 	welodnfru
centuries	100 years	tsenrcuie
beginning	start	niibegngn
influence	some people can do this	ieencufln
gentlemen	a man of refinement	etmenlgne
preparing	make ready 	iganrrppe
suggested	make a proposal,	tdegeugss
permanent	forever, always	erpnntema
literally	just like that	lrietlyal
financial	a big crisis recently	ainlcfani
intention	planned action	nntioenit
countries	nation	ocnsueitr
dangerous	 risky	runoesadg
completed	finish	eepcdlmto
radiation	nuclear	dnoritaia
recognise	know	cniseroeg
delivered	deliver (a speech, oration, or idea)	ieeddlrev
temporary	short term	maryopetr
statement	a message	tnasettem
committee	a group of people	imtmotece
resources	reserves	orercuses
shoulders	part of your body	dslohesur
celebrate	Birthdays	eetearcbl
immediate	of the present time 	iiamdtmee
available	obtainable 	baaavelli
confirmed	establish with fact	oridefcnm
wondering	a wish to know something	deowgnirn
difficult	hard	diftuilcf
ancestors	descended 	sacsnoetr
objection	protest	ijetbnooc
gentleman	a man of refinement	lemetnagn
scientist	a job	escisttni
political	Sinn Fein, DUP, etc.	ioaciltpl
creatures	a living organism	cesureart
procedure	course of action	urperoced
character	CJ, Bertie had plenty of this	arcacther
tradition	an inherited pattern 	oiidttran
Halloween	Oct 31st	eahewolnl
breathing	a requirement  	rhnebgtia
important	of great significance 	tioaprnmt
professor	Job at a university	oproersfs
desperate	in need of help	tedapsree
footsteps	the sound of someone walking	tstoposef
apologise	Sorry	gaopoesli
customers	you are one	rsectusom
confident	assurance	dotcifnen
satisfied	meet expectations	diaiestsf
someplace	in or at or to some place	aoplcemse
criminals	robbers	airnmcsil
disappear	get lost	adiappser
naturally	as might be expected	rnatlulay
hopefully	positive	hploueylf
emergency	sudden crisis	eeyegcnmr
warehouse	a big building	arsowhuee
delighted	pleased	iehdgltde
happening	an event	negaippnh
expecting	pregnant	eeigxtcnp
separated	act as a barrier	psatedare
chocolate	tastes good	lceotoach
connected	joined	decntnoec
detective	Magnum PI	teevtdice
developed	make something new	dvpodleee
interests	a sense of concern	netistrse
certainly	sure	nictraeyl
satellite	 orbits around the earth	ialstltee
meanwhile	the time between 	hnaemewli
introduce	say hello	eocndtuir
equipment	kit	nmpteeiuq
fantastic	super	aftsanitc
lightning	thunder	nglnitigh
promotion	move up the ladder	opointrom
interrupt	temporarily stops	rnutierpt
colleague	an associate	leocgluae
advantage	point in tennis	aangadetv
territory	land	rteyrroit
yesterday	 before today	rastdyeey
forgotten	stop remembering	foetrgotn
furniture	in a room	urfirneut
dehydrate	remove all water	eddeyahrt
spiritual	holy	tirpaulis
rehearsal	practice	aelahrers
overnight	sleep over	ogenhitvr
determine	establish	nedtemire
elsewhere	in or to another place	eewseelhr
practical	actual use 	irlptccaa
operating	control	ngreoatpi
apologies	sorry	ogipelsoa
corrected	make right or correct	rdctceeor
remaining	stay the same	gnenmirai
anonymous	unknown	moausyonn
continent	land mass	eionctnnt
described	portrayed	bridsedec
attracted	direct toward itself 	cdeattatr
believing	understanding	legbnievi
discussed	talked about	ssceuidsd
attacking	start warfare	iankttagc
dedicated	give entirely	adeicedtd
corporate	big business	orrpatceo
requested	 ask for	sueetreqd
surprises	astonishment 	rssirueps
cooperate	work together 	tepceooar
worthless	lacking in  value	hstserlwo
relations	family	rsnaeotli
infection	puss on a cut	inifontce
suspended	hang freely	psseuddne
volunteer	helps for free	rnuolteev
communist	USSR	miumstcon
blackmail	extortion	kblalcima
attempted	make an effort	edptemtat
gathering	a group of persons	egtranigh
institute	an association	tintiestu
therapist	a skilled person	asitrepth
residence	a house or home	esecnired
democracy	we live in one	dcmroyeca
published	we do this with our content	bhleupdsi
execution	carry out	oteeunxic
technical	difficult	chlticnae
disturbed	move deeply	rbisdduet
wandering	travelling about 	wnarigden
apologise	sorry	asgleiopo
broadcast	RTE & BBC do this	artbcados
behaviour	the action of something 	hibeorauv
performed	carry out an action	odefpremr
respected	think much of	dsreeepct
finishing	appearance of a surface 	fisignihn
affection	 feeling of liking	ictoefafn
privilege	a special advantage	vgilepire
celebrity	a widely known person	belrteiyc
defending	in defence of	fgdeniedn
suspicion	might be the case	scoiuipns
convicted	declare guilty	divncetco
confusing	mistake one thing for another	suiongfnc
generally	usually	ryeelnagl
receiving	given something	ievnrecig
reporters	Lots work for this title	rreropets
Manhattan	Part of New York City	nnhaaamtt
scheduled	plan for an activity	sehudcled
negotiate	discuss	atoneiget
reference	a remark	eceneerfr
collected	gather together	deloltecc
survivors	who lives through	oivsrvusr
fortunate	lucky	outretnfa
encounter	meeting	ectnnerou
passenger	travelling  	rsgpseena
accompany	be present 	mocypanac
spreading	distributing 	daepnrigs
hilarious	funny	hiarosuli
exclusive	lots of these with this title	eixlvsuce
confusion	disorder 	foconunsi
programme	an announcement of the events	rrmepogam
contacted	 establish communication with	ntctoacde
chemistry	the science of matter	tescimhyr
companion	a friend	poncioanm
butterfly	beautiful insect	uytrelftb
establish	set up	sebhatsli
gratitude	thankfulness	urdgieatt
exception	not the rule	itcnepxeo
essential	important  	tinelssae
magazines	publication	emzgsania
murmuring	low sounds	gmrunuirm
announced	make known	ocdnnaune
pregnancy	in utero	aepcnygnr
innocence	young  	cincnoene
presented	given	eseetdprn
remembers	recall knowledge	reremebms
household	a social unit living together	hoelhsdou
possessed	have as an attribute	psseseods
curiosity	want to learn more 	csiioytru
materials	the tangible substance	lriaesmat
standards	a basis for comparison	adsasnrtd
offensive	not nice	fofivesne
qualified	prove capable 	ilefidqau
fireworks	New Year's eve	fkerosirw
correctly	Accurate	toclreyrc
collapsed	break down	ocdesalpl
eliminate	end	eaiienlmt
cancelled	annul	nleclcdae
graduated	complete studies	daeduargt
hospitals	Doctors, nurses	tsloipsha
marijuana	sometimes called grass	jamnraiua
strongest	power greater than average	ntsersotg
evolution	Charles Darwin	litouenov
bartender	Sam in Cheers	ebeadrrnt
inaudible	impossible to hear	ueailnbdi
perimeter	the boundary line	reteermpi
increased	become bigger	dasncerie
scoundrel	a wicked or evil person; someone who does evil deliberately	sneuodrcl
conscious	intentionally conceived	sisonucco
landscape	an expanse of scenery	apldsncae
invention	creation	innivtnoe
integrity	good quality	iriynetgt
objective	the goal intended 	obctjveei
briefcase	carrying papers	ceabfseri
embarrass	feel self-conscious	mrsbrsaae
encourage	contribute to the progress	rcgnaueeo
heartbeat	in your chest	teehrabta
identical	exactly alike	aentciidl
classical	traditional genre	cassilcla
neighbour	next door	rhiubnoeg
vengeance	revenge	enegvacne
substance	the real physical matter	untsacbes
alcoholic	addicted	cahiocllo
automatic	type of gearbox	uaatictmo
salvation	saving from evil	aotalnivs
slightest	small in quantity	sstiegtlh
explosive	dangerous  	oxliepsve
forensics	scientific tests	eoscfrisn
ambitious	desire for success	ambitsiuo
orchestra	a musical organisation	srcohrtea
succeeded	attain success or reach a desired goal	ecsdeudce
Jerusalem	city in Israel 	jsmrleeua
frequency	the number of occurrences	nryquceef
architect	Dermot Bannon	atetchicr
instantly	without delay	tlinsanyt
orphanage	institute with kids	aepgnaorh
autograph	signature	ragptaouh
obsession	an irrational motive	sobosisen
lifestyle	a manner of living 	tleieflys
dimension	length, width, height	insmidoen
bodyguard	Kevin Costner played one	rbdygaudo
courtroom	Judges rule here	urorocomt
pointless	TV gameshow	psslontie
demanding	request urgently and forcefully	edmndigna
efficient	wasting little  time or effort	eitfencfi
slaughter	the killing of animals 	rhaetlsgu
marijuana	illegal plant	auiarmjan
legendary	famous	elgdyraen
detention	a state of being confined 	dnentioet
breakdown	falling down	rodnwebka
moonlight	visible on some clear nights	nihlmotog
scattered	go in different directions	rtetdasce
crackling	nice on ham or pork	caglcinkr
entertain	provide entertainment for	trntieena
particles	 a tiny piece of anything	asrpctlei
violation	a crime	ioovlitna
universal	a major studio from USA	vsuilrane
shattered	break into many pieces	hsetrdtea
departure	leave  	rpteeadru
spaghetti	type of pasta	aigetthps
contained	included	incdenato
sustained	kept going	sstdeunia
generator	produces electricity	gnrateero
continent	land mass	inentncto
godfather	Marlon Brando played one	tegodahfr
probation	a trial period	tiobparno
hurricane	cyclone	aienucrrh
flattered	praise somewhat dishonestly	arlteetfd
collector	a person who gathers things	ololecrct
physician	Doctor   	pniaichsy
submarine	JP Holland invented this	asimubren
astronaut	spaceman	nrastatuo
classroom	a room in a school	rcoasomls
condemned	express strong disapproval of	dmenecond
muttering	a low continuous sound	muirgttne
selection	the act of choosing	cesntolei
squeaking	high-pitched noise	iusnaeqkg
alongside	side by side	nsaliodge
translate	one language into another language	slatrenat
policemen	a member of a police force	neilecpom
primitive	stone age people	mpvriieit
defensive	an attitude	efdesneiv
sensation	awareness of stimulation	nastsneoi
strangled	kill by squeezing the throat	nsgrlated
clearance	the space between them	crleenaca
realistic	awareness of things as they really are	taiiclesr
engineers	required for building	eniseegrn
inherited	obtain from someone after their death	tnirhiede
arguments	verbal fighting	nsumrtgea
musicians	artists	ssuiicmna
insulting	treat, mention, or speak to rudely	lnuisngit
sincerely	without pretence	elyeinscr
spaceship	a spacecraft 	hscaipsep
injection	via a needle	cijnietno
virtually	in essence	vltuiayrl
formation	4-4-2 is one	rnaimtfoo
murdering	kill intentionally	undgeirrm
repeating	the act of performing again	trangiepe
vegetable	carrots, pea etc.	teaveegbl
languages	Irish, English, Spanish etc.	gsngaluea
pronounce	speak in a certain way	nnoerupoc
elections	a vote to select the winner	elsneicto
narrating	provide commentary	antnarrig
imagining	form a mental image	iniaingmg
fulfilled	put in effect	dfelluilf
dinosaurs	large and extinct	osnsudrai
rebellion	there was one in 1798 in Ireland	rliobneel
preferred	like better	frrepdere
battalion	an army unit 	inatoatlb
moustache	hair on the upper lip	tceoumsah
assaulted	attack someone 	laadstesu
surviving	continue to live 	isivngvru
container	on ships, trucks etc	eaortnnic
indicates	be a signal for	esdcaitni
sanctuary	a consecrated place	casnraytu
producers	someone who manufactures something	sceroprdu
righteous	accepted standards of morality or justice	otshiegru
specialty	a talent or like	ctsaplyie
regularly	often	rlgruleay
gradually	slow and sure	rayagldul
injustice	not fair	ucstienij
graveyard	land used for burials	arrvydgea
strangely	in a strange manner	egnaltsry
activated	put in motion or move to act	aveitatdc
installed	set up for use	sdnleitla
discharge	sudden giving off of energy	ehgsdarci
authentic	original	citeuahtn
addiction	dependent on something	ddonactii
involving	connect closely 	ivnlonvig
poisonous	dangerous to eat	nosspoiuo
diagnosis	identifying the cause	aoidssign
locations	places	oinltcsao
extension	addition to a house	eonensixt
transform	change	rmsornfta
providing	give something useful	iiordgpnv
overboard	to extremes	orodvbaer
elaborate	add details	atblreaoe
mysteries	something that baffles	seyrmstei
mechanism	system of parts	anmemcshi
smuggling	secretly importing 	sggnlmigu
countless	lots and lots	lusctenos
distorted	out of shape	tdrseoidt
superhero	superman, spiderman	rsepeoruh
terrorism	unlawful violence	rsietmror
decorated	made more attractive	doacdtree
specially	in a special manner	lisypaelc
producing	bring forth or yield	dnrgcupoi
occasions	special times	coascosin
inventory	a detailed list of stock	onvirntey
imaginary	fake	magarniiy
artillery	large but transportable armament	ltrlaryie
telescope	a magnifier of images of distant objects	elpeotcse
shameless	feeling no shame	ahmlsesse
worldwide	throughout the entire world	dlrwewoid
treasures	a wealth in the form of money or jewels	sseaerrtu
cafeteria	a restaurant	eaceitarf
monastery	the residence of a religious community	omntaesyr
impatient	restless 	imnaetipt
predicted	tell in advance	dcdpteire
ignorance	the lack of knowledge 	niagencro
civilised	stage of cultural development	veiisidlc
competing	engage in a contest	pnoecimtg
carpenter	a woodworker 	pratrneec
upsetting	disturb the stability of	ugepttnsi
narcotics	drugs	ctisacron
foreigner	from a different land	erigfoner
microwave	small cooking unit	ceawovmri
travelled	Somebody who moves a lot, is well…	tdaleerlv
groceries	Tesco & Dunnes supply these	ecgsroeir
imitating	copying	ttmginiia
informant	a person who supplies information	fniontmar
fantasies	imagination unrestricted by reality	senasaift
fisherman	works on the sea	sfiheranm
nightclub	late night disco	nubligcth
overheard	heard	drveehrao
machinery	tractors, diggers etc.	riycmhnae
predators	Lions, sharks etc.	prsadtreo
expertise	skilled	sexirepet